#.........
#.####....
#.......#.
...###....
#.........
.......#..
....#.....
....#...#.
##........
.....##...
